000110000000000
000110000000000
000000000000000
000000000111000
000000000100000
111000000000000
000000000000000
000000000000001
000000000000001
000000000000001
000001000001111
000001000000000
100001000000000
100000000000000
100000000000000
000000000001000
000000100000000
000000100000000
000000100000000