000000010000000
000000010000000
000000000000000
000000000000001
000010000000001
000010000000000
000000000010000
111000000010000
100000000100000
100000000100000
000000000000000
000000000000000
000000000000000
000000000000000
000000000000000
000011000110000
000010000010000
000010000010000
000010000010000
000010000010000
